.  S0  .  .  .  S1  .  .  @  .  @
.  .  .  .  .  .  .  .  .  .  .
.  .  .  .  .  .  .  .  @  .  .
.  .  .  .  .  .  L0W  .  @  .  .
.  .  .  .  .  .  G  .  .  .  .
.  .  .  .  @  .  L1N  .  .  .  @
.  .  @  @  .  .  .  G  .  .  .
F  .  .  G  .  .  .  .  .  .  .
.  .  .  F  .  .  .  .  .  @  .
.  .  .  .  .  @  .  .  .  .  .
.  .  G  G  .  .  .  .  .  .  .