.  .  .  @  @  .  .  @  .  .  .
G  .  .  .  .  .  .  .  .  .  @
@  .  @  L0E  .  .  .  .  .  .  .
.  .  .  F  L1W  .  @  .  .  .  .
.  .  .  .  .  .  .  .  .  .  .
.  .  .  .  .  .  .  .  .  G  .
G  .  .  .  .  .  G  .  .  .  .
S1  F  .  .  .  G  .  S0  .  .  .
.  .  .  .  .  .  .  .  .  .  .
@  .  .  .  .  @  .  .  .  .  .
.  .  .  .  .  .  @  .  .  .  .