G  .  .  .  .  G  .  .  .  S0  .
.  .  .  .  .  .  .  .  .  F  L0S
.  .  .  .  S1  .  .  .  .  .  .
.  .  F  .  .  .  .  .  G  .  .
.  .  .  @  .  .  .  @  .  .  .
.  .  .  .  .  .  .  .  .  .  @
.  .  .  .  .  G  .  .  .  .  .
.  .  .  .  .  .  .  .  .  .  @
.  .  .  @  .  @  .  .  .  .  @
L1E  .  @  .  .  .  .  .  .  .  G
.  .  .  .  .  @  .  .  @  .  .