.  .  .  S0  .  .  .  .  .  .  .
.  G  .  .  .  .  .  .  .  @  S1
G  @  .  .  .  @  .  L0W  .  .  @
.  @  .  G  .  .  .  .  .  .  .
.  .  .  .  .  G  .  .  .  .  .
.  .  .  .  .  .  .  .  .  .  G
.  F  .  .  @  .  .  .  .  .  .
.  .  .  .  F  .  .  .  .  .  .
L0N  @  @  .  .  .  @  .  .  .  .
.  .  .  .  @  .  .  .  .  .  .
.  .  .  .  .  .  .  .  .  .  .