.  .  .  .  .  .  .  .  G  .  .
.  G  .  .  L1N  .  .  .  .  @  .
.  .  @  .  .  .  @  .  .  L1N  .
.  .  .  .  .  .  .  @  F  .  .
.  .  .  .  .  .  .  .  @  .  .
.  G  .  .  .  .  G  .  .  .  .
.  .  .  .  .  .  @  .  .  F  .
G  .  .  .  .  .  .  .  .  .  .
.  @  .  .  .  .  .  .  .  .  .
.  .  @  .  .  .  .  S1  @  .  .
.  .  .  @  .  S0  .  .  .  .  .