.  .  .  .  .  .  .  .  .  .  .
.  S1  .  .  .  .  .  @  .  @  .
.  .  .  .  .  .  .  @  .  .  .
.  .  .  .  L0S  .  .  .  .  .  @
.  .  .  .  L0S  .  .  .  .  .  G
.  .  @  .  @  .  .  .  .  .  .
.  .  .  F  .  .  .  .  .  @  @
.  .  .  .  .  .  .  .  .  .  F
.  .  .  .  .  G  .  .  .  .  @
.  .  .  .  G  .  .  .  @  .  .
.  .  G  .  .  .  G  .  .  S0  .