.  .  .  L0S  .  .  .  .  F  S0  .
.  .  .  .  .  @  .  .  .  G  .
.  .  .  .  .  .  .  .  .  .  .
.  .  G  .  .  .  .  .  @  .  .
.  .  .  G  .  .  .  .  @  .  .
.  @  .  F  .  .  @  .  .  .  .
@  .  .  .  .  .  .  .  .  .  .
.  S1  .  .  .  @  .  .  .  G  .
.  .  .  .  .  .  G  .  .  .  .
L0W  @  .  .  .  .  .  .  .  .  .
@  .  @  .  .  .  .  .  .  .  .