.  @  .  .  .  .  @  .  .  G  .
.  .  .  .  .  .  .  .  S1  .  .
.  .  .  .  .  G  .  .  .  @  .
.  .  .  .  .  .  .  .  .  G  .
.  .  .  .  .  .  .  .  .  .  .
@  .  .  L1E  .  .  .  .  .  @  .
.  F  .  .  .  .  .  .  .  @  .
.  .  .  .  .  .  .  .  .  L1W  .
.  .  .  @  .  .  .  .  .  S0  .
@  .  .  .  .  .  @  .  .  .  .
.  F  G  .  .  .  .  G  @  .  .