.  .  .  @  @  .  .  .  .  .  .
.  S1  .  .  .  L1S  G  .  .  .  .
.  .  .  .  .  .  .  .  .  G  @
.  .  .  .  .  .  G  .  .  F  @
.  .  .  .  .  @  .  .  .  .  .
.  .  .  .  G  .  .  .  .  .  .
.  L1E  .  .  .  .  .  .  .  @  .
@  .  .  .  .  .  .  .  .  .  .
G  .  .  .  .  .  .  .  .  S0  .
.  .  .  .  .  .  @  .  .  .  @
.  .  .  .  .  .  .  F  @  .  .