.  .  .  .  .  .  F  @  .  .  .
.  .  .  G  .  F  .  .  .  .  .
L1E  .  .  .  .  @  @  .  .  G  .
.  .  @  .  L1N  .  .  .  .  .  .
@  .  .  .  .  .  .  G  .  .  .
.  .  .  .  @  .  .  .  @  .  .
.  .  .  .  .  .  .  .  .  .  .
@  .  .  .  .  .  .  .  .  .  G
S1  .  @  .  .  .  .  .  .  .  .
.  .  .  S0  @  .  .  .  .  .  .
.  .  .  .  .  .  .  .  .  .  G