.  .  .  @  .  .  @  .  .  .  .
.  .  .  .  .  .  .  .  .  .  .
.  .  S1  .  .  .  .  .  @  .  .
.  @  @  .  .  .  @  .  .  .  .
.  .  .  .  @  .  .  .  .  .  .
.  .  .  .  .  .  .  S0  G  .  .
.  .  F  .  .  @  .  .  .  .  .
G  .  .  .  L0N  G  .  .  .  .  G
.  .  @  .  .  .  .  .  .  .  F
.  .  .  .  .  .  .  .  .  @  G
.  .  .  L0W  .  .  .  .  .  .  .