.  .  .  .  G  .  .  .  @  .  .
@  .  .  @  .  .  .  .  .  .  .
@  F  .  S1  @  .  S0  .  .  .  .
.  .  .  .  .  .  .  .  .  .  .
@  .  .  @  .  .  @  .  .  .  .
F  .  .  G  .  .  .  .  .  .  .
.  .  .  G  .  .  .  .  .  .  .
.  G  .  .  .  .  @  .  .  .  .
L1N  .  .  .  .  .  .  G  .  .  .
L1E  .  @  .  .  .  .  .  .  .  .
.  .  .  .  .  .  .  .  .  .  .