@  .  .  .  .  .  .  .  @  F  .
.  .  .  .  @  @  .  .  .  .  .
.  .  G  .  .  .  .  .  .  .  .
.  .  .  .  .  .  .  S0  @  .  S1
.  .  .  .  @  .  .  .  .  .  F
.  .  .  .  .  .  .  @  @  .  .
.  .  G  G  .  .  .  .  .  .  .
.  .  .  .  .  .  .  .  L1W  .  .
.  .  .  .  G  .  .  .  .  .  .
@  .  G  .  .  .  .  .  .  .  .
.  .  @  .  .  .  .  .  .  .  L1W