G  .  .  .  .  .  .  .  @  .  .
.  .  .  .  .  .  .  .  .  .  .
.  .  .  .  .  L1W  @  .  .  G  .
.  .  @  .  @  .  .  .  .  @  .
.  G  .  .  .  .  .  .  .  .  @
.  .  .  .  .  .  .  .  .  .  .
.  @  .  .  S0  .  @  .  L1N  .  .
.  .  .  .  .  .  .  .  .  .  .
.  F  .  .  @  .  G  G  .  .  .
.  .  .  .  .  @  .  .  .  .  .
.  S1  .  .  .  .  .  F  .  .  .