.  S0  .  .  .  .  .  .  .  @  .
.  .  .  .  .  .  .  .  .  .  .
.  .  G  L0E  G  F  .  @  .  .  .
.  .  .  .  .  .  G  .  @  .  .
.  .  .  .  .  .  .  .  .  .  .
.  @  .  .  .  .  .  @  .  L1W  .
.  G  .  .  .  .  .  .  @  .  F
G  .  .  .  .  .  .  .  .  .  .
.  .  .  .  .  .  .  .  .  .  .
.  .  .  @  .  .  .  .  .  .  @
.  .  .  .  .  .  .  @  @  S1  .