.  .  .  .  .  .  @  .  .  .  .
.  .  .  .  G  .  .  .  .  .  .
G  @  @  .  .  .  .  .  @  .  .
.  L0S  .  .  .  .  F  .  .  .  .
.  .  @  @  .  @  .  .  .  S1  .
.  S0  .  G  .  .  .  .  .  .  .
.  .  .  @  .  .  .  .  L1N  .  @
.  .  .  .  .  .  .  .  G  .  .
.  .  .  .  .  .  .  .  .  .  .
.  .  .  .  .  .  .  .  .  .  .
.  .  F  .  .  .  G  .  .  .  @