.  @  .  @  .  .  .  .  .  @  .
.  .  .  .  .  .  @  .  .  .  .
.  .  .  .  .  G  .  .  .  .  .
.  .  F  .  S0  .  .  .  .  .  @
.  .  G  .  .  .  .  .  @  .  .
.  .  .  .  .  .  .  .  .  .  .
.  .  .  .  L0E  .  .  .  .  .  .
G  .  G  .  .  .  .  .  G  .  F
.  .  .  .  .  .  .  .  .  .  .
.  @  .  .  .  .  .  S1  .  .  .
@  .  .  .  .  .  @  .  L0E  @  .