.  .  F  .  .  .  .  .  .  @  .
.  .  .  .  .  .  .  .  .  .  .
.  .  .  .  .  .  .  .  @  .  .
.  .  .  .  .  G  .  .  .  .  .
.  .  @  G  .  .  .  @  G  L0E  .
.  S1  G  .  .  .  .  .  .  @  .
.  @  .  .  .  .  .  @  .  L0S  .
S0  .  .  F  .  .  .  .  .  .  .
.  .  .  .  @  .  .  .  @  .  .
.  .  .  @  .  .  .  .  .  G  .
.  .  .  .  .  .  .  .  .  .  .