.  .  .  .  .  .  .  F  .  .  .
G  @  @  .  .  .  .  L0N  .  .  .
.  .  @  .  .  .  @  .  @  @  .
.  S0  .  .  .  .  .  .  .  .  .
.  .  .  @  .  .  @  .  G  .  .
.  .  .  .  .  .  .  .  .  G  G
.  .  .  .  .  .  @  .  .  F  .
.  .  S1  .  .  .  .  .  .  .  .
.  .  .  .  .  .  .  .  .  .  .
.  G  .  .  .  .  .  .  L1W  .  @
.  .  .  .  .  .  .  .  .  .  .