.  .  .  @  .  @  .  .  .  .  .
.  .  .  .  .  .  .  .  .  .  .
.  .  .  .  .  .  .  .  .  F  .
.  .  .  .  .  .  .  .  .  .  .
.  G  @  .  .  L0N  .  @  .  .  .
.  .  .  F  .  .  .  .  .  @  .
.  @  G  .  .  .  .  .  .  .  .
.  G  .  .  G  G  .  .  .  @  .
.  .  .  .  .  .  @  .  .  .  .
.  S1  L1W  .  .  .  .  .  .  .  .
@  .  .  .  .  .  @  .  .  .  S0