.  .  .  .  .  .  .  .  S1  .  F
.  .  .  .  .  .  L1E  .  @  .  @
.  .  .  .  @  .  .  @  .  .  .
.  .  F  .  .  .  .  .  .  .  .
.  .  @  .  .  .  .  .  .  .  G
@  .  @  G  .  .  .  G  .  .  L0E
.  G  .  .  .  .  .  @  .  .  .
.  .  @  @  .  .  .  .  .  .  .
.  .  .  .  .  .  .  .  .  .  .
.  .  .  .  .  .  G  .  .  .  .
.  .  .  .  .  .  .  .  S0  .  .