.  .  .  G  .  .  .  .  .  .  .
.  .  .  .  .  .  .  .  S1  .  G
.  .  .  .  .  @  .  @  .  @  .
.  .  .  .  .  .  .  @  .  @  .
.  @  G  .  .  @  .  .  .  .  .
.  .  .  .  @  F  .  .  .  .  .
.  .  L1N  .  G  .  .  .  S0  .  .
.  @  .  .  .  .  .  .  @  .  .
L1E  .  .  .  .  .  .  .  .  .  .
.  .  .  .  .  .  G  .  .  .  .
.  .  .  .  .  F  .  .  .  .  .