.  .  .  .  G  .  .  .  .  .  .
.  L1S  .  .  .  .  .  .  .  .  G
G  .  .  .  G  .  .  .  .  .  .
.  .  .  .  .  .  .  .  .  .  @
.  .  .  .  .  @  .  F  .  .  .
.  .  .  .  .  S0  .  @  .  .  .
.  .  .  .  .  .  .  F  @  .  .
@  .  .  G  .  .  .  @  .  .  .
.  .  .  .  @  .  .  .  .  S1  .
.  .  .  .  .  .  .  .  .  .  @
.  .  .  .  @  .  .  .  .  @  .