.  .  .  .  .  .  S0  .  .  .  .
G  .  .  .  .  L1W  .  F  .  .  .
.  .  .  .  .  .  @  .  .  G  @
.  .  .  .  .  .  .  .  .  .  .
.  .  .  .  .  @  .  .  .  L1W  .
@  .  F  @  .  .  .  .  S1  .  .
G  .  .  .  .  .  .  @  .  .  .
.  .  G  .  .  .  .  .  .  .  .
.  .  .  .  .  .  .  .  .  .  .
.  .  .  .  .  .  .  @  .  .  @
.  .  .  .  .  G  .  .  @  .  @