.  .  .  .  F  @  .  .  .  .  F
G  .  .  .  .  .  .  S1  @  .  @
.  .  .  .  .  .  .  .  .  S0  .
.  .  .  .  .  .  .  .  .  .  .
.  .  @  .  @  G  .  G  @  .  .
.  .  .  @  .  .  .  L0W  .  .  .
.  .  .  .  .  .  .  .  L0S  .  .
.  G  .  .  .  .  .  .  .  .  .
@  .  .  .  .  .  @  .  G  .  .
.  .  .  .  .  .  .  .  .  .  .
.  .  .  .  .  .  .  @  .  .  .