.  .  .  .  G  .  .  @  .  .  .
.  G  .  @  .  .  .  .  .  .  .
.  .  .  .  .  @  .  .  .  .  G
.  .  .  .  .  .  .  F  .  @  .
.  .  L1N  G  @  .  .  .  .  .  .
.  .  .  .  S1  .  .  .  .  .  .
.  .  .  F  .  S0  .  .  .  @  .
.  @  .  .  .  .  .  .  .  .  .
.  .  .  .  .  .  .  .  .  @  .
.  .  .  .  .  .  .  .  @  .  .
.  G  .  .  .  .  .  .  .  .  @