.  .  .  .  .  @  .  .  G  .  .
.  .  .  .  @  .  .  .  .  .  S0
.  .  .  .  .  L1W  .  .  .  .  .
.  .  .  .  .  .  .  .  .  G  .
F  .  .  .  .  .  .  @  .  .  .
.  .  .  .  .  .  @  .  .  .  .
.  .  .  @  S1  .  .  @  .  .  .
.  .  .  .  .  @  .  .  .  .  .
.  .  .  .  @  .  .  .  L1S  F  .
G  .  .  .  .  G  .  .  .  G  .
@  @  .  .  .  .  .  .  .  .  .