.  .  .  .  .  .  .  .  .  .  .
@  .  .  .  .  .  S0  .  @  .  .
.  .  @  .  .  .  .  F  .  .  .
.  .  .  .  @  .  .  .  G  .  .
.  .  F  .  G  .  .  .  .  .  .
@  .  .  .  .  .  .  .  .  .  .
.  .  .  .  @  .  @  .  @  .  G
.  G  @  .  .  .  S1  .  .  .  .
.  .  .  .  .  .  G  .  .  .  .
L0E  .  .  .  .  .  .  .  .  .  .
.  .  .  .  .  .  @  .  .  .  .