.  .  .  .  .  G  @  @  .  .  .
.  .  .  .  @  .  .  .  .  .  .
.  .  .  .  .  .  .  .  .  .  .
.  .  .  @  .  .  F  .  .  .  G
.  @  .  .  .  @  S1  .  .  .  L0S
.  .  .  .  .  .  .  .  @  .  .
.  .  .  .  @  G  S0  .  .  F  .
.  .  .  .  .  .  .  .  @  .  .
.  .  .  @  .  .  .  .  G  .  .
G  .  .  .  .  L1N  .  .  .  .  .
.  .  .  .  .  .  .  .  .  .  .