@  .  @  .  .  @  @  F  .  .  .
.  .  .  .  @  G  .  .  .  .  .
.  @  .  .  F  .  .  .  .  @  .
.  .  .  .  .  .  .  .  .  .  .
.  .  L1W  .  .  .  .  .  .  G  .
.  .  .  .  G  .  .  G  @  .  .
.  .  .  .  .  .  .  .  .  .  .
S1  .  .  .  .  .  .  .  .  .  @
.  .  .  .  S0  .  .  .  .  .  .
.  .  .  @  .  .  .  .  .  .  .
.  .  .  .  .  .  .  .  L1N  .  G