.  .  .  .  .  .  L1W  .  G  .  .
.  .  .  .  .  .  .  .  .  .  .
G  .  .  .  S1  .  .  .  .  .  .
.  .  .  .  .  @  .  .  .  L0E  .
.  .  @  .  .  @  .  .  F  .  .
.  S0  @  .  .  .  @  @  .  .  .
.  .  .  @  .  .  .  .  .  .  @
@  .  .  .  G  .  .  .  .  G  .
.  .  @  .  .  .  .  .  .  .  .
.  .  .  .  .  .  .  .  .  .  .
.  .  .  G  F  .  .  .  .  .  .