.  .  .  @  .  .  .  .  .  .  .
.  S1  .  .  .  .  .  .  @  .  .
.  .  .  .  .  F  L1W  .  .  .  .
.  .  .  .  .  F  .  .  .  .  L1S
.  .  .  @  G  .  @  .  .  .  .
@  .  .  .  .  .  .  .  .  .  .
.  .  .  @  @  .  .  .  .  .  @
.  G  .  S0  .  .  .  .  .  .  .
.  .  G  .  @  .  .  G  .  .  .
.  .  .  .  .  .  .  .  .  .  .
.  G  @  .  .  .  .  .  .  .  .