.  L1E  G  .  .  .  L0W  .  .  .  @
.  .  .  .  .  .  .  .  .  .  @
.  .  @  .  .  F  .  .  .  .  .
.  .  .  .  G  G  .  .  .  @  .
.  S0  .  .  .  .  @  .  .  .  .
.  F  .  .  .  .  .  .  .  G  .
.  .  @  .  .  .  S1  .  .  .  .
.  .  .  .  .  .  .  .  .  .  .
.  .  .  .  G  .  .  .  .  .  .
.  @  .  .  .  .  @  .  .  .  .
.  .  .  .  .  .  @  .  .  @  .