.  .  .  .  .  .  F  .  .  .  .
.  .  G  .  .  .  .  .  @  .  .
L1E  .  .  .  .  .  .  .  .  .  .
.  .  G  .  .  .  .  .  .  .  .
.  .  .  .  .  .  .  .  .  S0  .
@  .  .  .  .  @  .  .  .  .  .
.  .  G  .  .  L0W  .  .  S1  .  .
.  .  .  .  .  .  @  .  .  .  .
.  .  .  .  @  .  G  .  @  .  .
.  .  .  .  .  @  .  .  G  .  @
@  .  .  .  .  .  @  F  .  .  .