.  .  S0  .  .  .  .  @  .  @  .
@  .  .  .  .  .  .  .  .  .  .
.  .  .  .  .  .  .  .  F  .  .
.  .  .  .  .  .  .  .  .  .  @
.  .  .  @  .  .  .  .  .  G  .
.  G  .  .  .  F  .  L0E  .  .  .
@  .  .  S1  .  L0S  .  G  .  .  .
.  .  .  .  .  .  .  .  .  .  .
@  .  .  @  .  .  .  .  G  .  .
.  .  .  .  .  .  .  .  .  @  .
.  .  .  .  @  G  .  .  .  .  .