G  .  .  .  .  .  .  .  .  .  L0W
.  .  .  .  .  @  .  .  .  G  @
@  .  .  .  .  G  .  .  .  .  .
.  .  .  @  G  .  .  .  .  .  .
.  .  .  .  .  .  G  .  .  .  .
@  .  .  .  .  .  .  .  F  @  .
.  .  .  S1  L1W  .  .  .  .  S0  @
.  .  .  @  .  .  .  .  .  .  F
.  .  .  @  .  .  .  .  .  .  .
.  .  .  .  .  @  .  .  .  .  .
.  .  .  .  .  .  .  .  .  .  .