.  .  .  @  .  .  .  @  .  .  .
.  .  .  .  L0W  .  G  .  .  .  .
.  .  .  .  @  .  .  .  .  .  .
.  .  .  .  .  .  .  .  .  @  .
.  .  @  .  .  S1  G  .  .  .  .
.  .  G  @  L0E  .  .  .  .  F  .
.  .  G  .  .  .  .  .  .  .  .
.  .  .  .  .  G  .  .  .  .  .
.  .  .  .  @  @  @  .  .  S0  .
.  .  .  .  .  .  .  .  .  .  .
.  .  .  .  .  .  .  F  .  .  @