.  .  .  .  .  S1  .  .  .  .  .
.  .  @  .  @  .  .  @  .  .  .
.  .  .  .  G  .  .  .  .  .  .
.  .  .  .  .  .  .  .  .  .  .
.  G  .  .  .  .  .  .  .  .  S0
.  .  .  .  .  .  .  .  .  .  .
.  @  @  .  .  .  .  .  .  .  @
G  .  .  .  .  .  .  .  .  .  .
@  .  .  G  .  .  .  .  .  .  .
.  .  F  .  .  @  L0S  .  .  .  @
.  .  .  .  @  F  G  .  .  .  .