.  @  .  .  .  @  G  .  .  @  .
.  @  .  .  .  .  G  .  .  .  .
L1N  .  .  .  S0  .  .  .  .  .  .
.  .  .  @  .  .  .  .  .  .  .
@  .  .  .  .  @  .  .  .  .  F
.  .  .  .  S1  .  .  G  F  .  .
G  .  .  .  .  .  .  @  .  @  .
.  .  .  .  .  .  .  G  .  .  .
.  .  .  .  .  .  .  .  .  .  .
.  .  .  L1W  .  .  .  .  .  .  .
.  @  .  .  .  .  .  .  .  .  .