@  .  .  .  .  .  .  .  @  .  .
.  .  .  @  .  .  .  .  G  .  .
.  .  .  .  @  .  @  .  G  .  .
.  .  S1  @  .  .  .  .  .  .  .
.  .  .  L1S  .  .  .  .  .  .  .
.  .  .  .  .  .  .  .  .  .  .
.  .  .  .  .  .  @  G  .  S0  .
.  .  .  .  .  .  .  .  .  .  .
.  .  .  F  G  .  .  .  .  .  .
.  @  @  .  .  F  G  .  .  @  .
.  .  .  .  .  .  .  .  .  L0W  .