.  .  .  .  .  .  @  .  .  .  .
.  .  .  .  .  .  .  .  .  F  @
.  .  .  .  .  .  .  G  .  .  .
.  .  .  .  .  .  .  .  .  .  .
.  .  .  .  @  .  .  G  .  G  .
.  .  .  .  .  @  G  .  .  .  .
.  S1  .  .  .  @  .  .  @  .  .
.  .  .  S0  .  .  .  .  .  @  L1W
.  .  .  .  .  .  .  .  .  .  .
.  .  @  G  .  .  .  @  .  .  .
@  .  .  F  .  .  .  .  .  .  .