.  .  .  .  .  .  .  .  .  .  .
.  .  .  .  @  .  .  .  .  .  .
.  .  G  G  .  .  @  @  .  @  .
.  .  .  .  S1  F  .  .  .  .  .
.  .  .  .  G  @  .  .  @  .  .
.  .  .  .  L1S  .  .  .  .  .  .
.  .  .  .  .  F  .  .  G  @  .
.  .  .  .  .  .  @  @  .  .  .
.  .  .  L1W  .  .  .  .  .  .  .
S0  .  .  .  @  .  .  .  G  .  .
.  .  .  .  .  .  .  .  .  .  .