@  .  .  .  .  .  .  .  .  .  .
G  .  @  G  .  L1W  .  .  @  .  @
.  .  S0  .  .  .  .  .  G  .  .
.  .  .  .  .  .  .  .  .  .  .
.  @  .  .  .  .  .  .  @  .  .
L0S  .  .  .  G  .  .  .  .  .  @
.  .  G  .  F  .  .  .  .  .  .
.  .  .  .  .  @  .  .  .  .  .
.  .  .  .  .  .  .  .  .  .  S1
.  .  .  .  .  .  .  @  @  .  F
.  .  .  .  .  .  .  .  .  .  .