.  .  .  .  @  S1  .  .  .  L1W  .
.  @  .  .  @  .  .  .  .  .  .
.  .  .  .  .  .  @  .  G  .  .
.  .  @  G  .  .  .  .  .  .  .
L0E  .  @  .  .  .  .  .  .  .  .
.  .  .  .  .  F  .  .  .  .  .
.  .  .  G  .  .  @  .  .  .  .
.  .  .  S0  @  .  @  .  .  .  .
.  .  .  .  .  .  .  .  .  .  .
.  .  .  .  .  .  .  F  .  .  .
.  .  .  .  G  @  .  G  .  .  .