.  .  .  .  L0S  .  @  .  .  .  .
.  .  .  .  .  .  .  .  .  G  .
.  .  S0  .  .  @  .  .  .  .  .
.  .  G  @  .  .  @  G  .  .  .
@  .  .  .  .  .  .  .  .  .  .
.  .  .  .  .  .  .  .  .  .  @
.  .  .  .  .  F  .  .  .  G  .
S1  .  .  .  .  .  .  .  .  @  .
.  L1S  .  .  .  @  .  .  .  .  .
.  .  .  .  .  .  .  .  @  G  .
.  .  .  .  F  .  .  .  .  .  @