.  @  .  .  .  .  .  .  .  .  @
.  G  .  .  .  .  S1  .  .  @  .
G  .  .  .  .  .  .  .  .  .  .
.  G  .  .  .  G  .  .  .  .  .
@  .  S0  .  .  .  .  .  .  .  L0N
.  .  .  .  .  .  .  .  .  .  .
@  .  .  .  .  .  .  .  @  F  .
.  .  .  F  .  .  .  .  .  .  .
.  .  .  @  .  G  .  .  .  .  .
.  .  .  @  @  .  .  .  L0S  .  .
.  .  .  .  .  .  .  .  .  @  .