.  @  .  .  .  .  .  .  .  .  .
.  .  .  G  .  F  .  .  .  .  .
.  .  .  .  .  .  .  .  .  .  G
.  .  .  .  @  .  .  .  .  .  @
.  @  .  .  .  .  .  .  G  .  .
.  @  S1  .  .  .  .  .  .  .  .
.  G  .  .  .  .  @  .  @  .  .
.  @  .  .  L1S  .  .  .  .  .  .
.  .  S0  .  .  .  .  .  .  G  .
.  .  .  .  .  .  .  @  .  .  .
.  .  .  .  .  F  L0S  .  .  .  @