.  @  .  .  .  .  @  .  .  .  .
.  .  .  .  .  .  .  @  .  .  .
.  .  .  .  .  .  .  .  .  .  .
.  .  .  .  .  .  .  .  @  .  .
.  L0E  G  .  .  .  .  .  @  .  G
.  .  .  .  .  F  .  .  .  .  .
.  .  .  @  @  .  .  .  .  .  .
.  .  .  .  .  .  .  .  L0N  .  .
F  @  .  .  S1  .  .  .  .  .  .
.  .  .  .  .  G  G  .  S0  .  @
.  @  .  .  .  .  .  .  .  G  .