.  @  .  .  S1  .  .  .  .  .  .
.  .  .  .  @  .  .  .  G  .  .
G  .  .  .  .  .  .  .  .  .  .
.  .  .  .  .  .  .  .  L0W  G  .
.  .  .  .  .  .  .  .  .  .  .
.  .  .  .  .  .  .  .  .  .  .
@  .  .  .  .  .  .  G  .  .  .
.  .  .  G  @  .  .  .  .  .  .
@  @  .  .  .  .  .  .  F  F  @
.  .  .  .  .  @  .  @  .  .  S0
L1W  .  .  .  .  .  @  .  .  .  .