.  .  .  .  .  G  .  .  .  .  .
.  .  .  .  .  .  .  L1N  .  .  .
@  .  @  G  .  @  .  .  .  G  .
.  .  .  S0  .  .  .  .  @  .  .
.  .  .  .  S1  .  .  .  .  .  .
.  .  G  F  .  .  .  .  L1S  .  @
.  .  @  .  .  F  .  .  .  .  .
.  .  .  .  .  .  .  .  .  .  .
@  @  @  .  .  .  .  .  .  .  .
.  .  .  .  .  .  .  @  .  .  .
.  .  .  .  .  .  .  .  .  .  G