  G  L2S . . . S1 S2 S3 . . . .  . 
  .   .  . . .  .  .  .  . . . .  .   
  S0   .  . . .  .  .  .  . . . .  .   
  @   @  . . .  .  .  .  . . . .  .   
 L0E  .  . . .  .  .  @  @ @ @ @  @   
  .   .  . . .  .  .  .  . . . .  .   
  .   .  . . .  .  .  .  . . . . L1W
  .   .  . . .  .  .  @  . G . .  .   
  .   .  . . .  .  .  @  @ @ @ @  @   
  .   .  . . .  .  .  .  . . . .  .   
  .   .  . . G  .  .  .  . . X X  .   
  .   .  . . .  .  .  .  . . X X  G   