  G  L2S . . S0 S1 S2 . . . . .  . 
  .   .  . . .  .  .  .  . . . .  .   
  S3   .  . . .  .  .  .  . . . .  .   
  @   @  . . .  .  .  .  . . . .  .   
 L0E  .  . . .  .  .  @  @ @ @ @  @   
  .   .  . . .  .  .  .  . . . .  .   
  .   .  . . .  .  .  .  . . . . L1W
  .   .  . . .  .  .  @  . G . .  .   
  .   .  . . .  .  .  @  @ @ @ @  @   
  .   .  . . .  .  .  .  . . . .  .   
  .   .  . . G  .  .  .  . . X X  .   
  .   .  . . .  .  .  .  . . X X  G   