  G     .  .  .   . . . .   . . . . S2 
  @     @  @  .   . . . .   . . . .  .   
  .     .  .  .   . . . .   . . . .  .   
  .     .  .  .   . . . .   . . . .  .   
  .     .  .  .   . . . L2S @ @ @ @  @   
  .     .  .  L1N . . . .   . . . .  .   
  .     .  .  @   . . . .   . . . . S3
  .     .  .  @   . . . @   . G . .  .   
  L0E   .  .  L0E . . . @   @ @ @ @  @   
  .     .  .  @   . . . .   . . . .  .   
  .     .  .  @   G X X .   @ . . .  .   
  S0    .  S1 @   . X X .   @ . . .  G   