  G     .  .  .   . . . .   . . . . S2 
  @     @  @  .   . . . .   . . . .  .   
  G     .  .  .   . G . .   . G . .  .   
  .     .  .  .   . . . .   . . . G  .   
  .     G  .  .   . . . L2S @ @ @ @  @   
  G     .  .  L1N . . . .   . . . .  .   
  .     .  .  @   . G . .   . . . . S3
  .     .  .  @   . . . @   . . . .  .   
  L0E   .  .  L0E . . . @   @ @ @ @  @   
  G     .  .  @   . . G .   . . . .  .   
  .     .  .  @   G X X .   @ . . .  .   
  S0    .  S1 @   . X X .   @ . . .  G   