@   @    . .  .
S1  .    . S0 .
@   .    . .  .
.   L0N  . .  .
.   .    . .  .
X   .    . .  X   
