.   S0 . S1 .
.   .  . .  .
@   .  @ G  @
L0E .  @ .  @
.   .  . .  .
X   .  . .  X   
