 .  S0 S1 S2 S3 . 
 .  .  .  .  .  .   
L0E .  .  .  .  .   
 .  .  .  .  .  .   
 .  .  .  .  . L0W
 .  .  .  .  .  .
 .  .  .  .  .  .   
 .  .  .  .  .  .
 .  .  .  .  .  .   
 .  X  X  X  X  .   
 .  .  .  .  .  .   
 .  .  .  .  .  . 
