@   @ @  @  @ @  @
@   . S0 S1 . .  @
@   . .  .  . .  @
L0E . .  .  G .  @
@   . .  .  . . L1W
@   . G  .  F F  @
@   @ @  @  @ @  @