  G  L2S . . S0 S1 S2 S3 . . . .  . 
  .   .  . . .  .  .  .  . . . .  .   
  .   .  . . .  .  .  .  . . . .  .   
  @   @  . . .  .  .  .  . . . .  .   
 L0E  .  . . .  .  .  @  @ @ @ @  @   
  .   G  G G G  G  G  .  . . . .  .   
  G   G  G G G  G  G  .  . . . . L1W
  G   G  G G G  G  G  @  . G . .  .   
  .   .  . . .  .  .  @  @ @ @ @  @   
  .   .  . . .  .  .  .  . . . .  .   
  .   .  . . G  .  .  .  . . X X  .   
  .   .  . . .  .  .  .  . . X X  G   