  G   @  . . S0 S1 S2 S3 . . . .  . 
  .   .  . . .  .  .  .  . . . .  .   
  .   .  . . .  .  .  .  . . . .  .   
  @   @  . . .  .  .  .  . . . .  .   
  @   .  . . .  .  .  @  @ @ @ @  @   
  .   .  . . .  .  .  .  . . . .  .   
  .   .  . . .  .  .  .  . . . .  @
  .   .  . . .  .  .  @  . G . .  .   
  .   .  . . .  .  .  @  @ @ @ @  @   
  .   .  . . .  .  .  .  . . . .  .   
  .   .  . . G  .  .  .  . . X X  .   
  .   .  . . .  .  .  .  . . X X  G   