  G  L2S G G S0 S1 S2 S3 G G G G  G 
  G   G  G G G  G  G  G  G G G G  G   
  G   G  G G G  G  G  G  G G G G  G   
  @   @  G G G  G  G  G  G G G G  G   
 L0E  G  G G G  G  G  @  @ @ @ @  @   
  G   G  G G G  G  G  G  G G G G  G   
  G   G  G G G  G  G  G  G G G G L1W
  G   G  G G G  G  G  @  G G G G  G   
  G   G  G G G  G  G  @  @ @ @ @  @   
  G   G  G G G  G  G  G  G G G G  G   
  G   G  G G G  G  G  G  G G X X  G   
  G   G  G G G  G  G  G  G G X X  G   