S0 @ . . . @ . . . @
.  @ . @ . @ . @ . @
.  @ . @ . @ . @ . @
.  @ . @ . @ . @ . @
.  @ . @ . @ . @ . @
.  @ . @ . @ . @ . @
.  @ . @ . @ . @ . @
.  . . @ . . . @ . X