.  . . . . . . . . . . . . . . . X
.  . . . . . . . . . . . . . . . .
.  . . . . . . . . . . . . . . . .
.  . . . . . . . . . . . . . . . .
S0 . . . . . . . . . . . . . . . .