.  . . . . . . . . . . . . . . . X
.  . . . . . . . . . . . . . V V .
.  . . . . . . . . . . . . . . . .
.  . . . . . . . . . . . . . . . .
S0 . . . . . . . . . . . . . . . .