.  . . . . . . . . . . . . . . . X
.  . . . . . . . . . . . . . V V .
.  . . . . . . . . . . . . . . . .
.  . . . . . . . . . . . . . . . V
S0 . . . . . . . . . . . . . . . .