.  . . . . . . . . . . . . . V . X
.  . . . . . . . . . . . . . V V .
.  . . . . . . . . . . . . . . . .
.  . . . . . . . . . . . . . . V V
S0 . . . . . . . . . . . . . . . .