.  . . . . . . . . . . . . . . . X
.  . . . . . . . . . . . . . . V .
.  . . . . . . . . . . . . . . . .
.  . . . . . . . . . . . . . . . .
S0 . . . . . . . . . . . . . . . .