. . . . . . . . @ . . . .
. . . . . . . . . . . . .
. . . . . . . . . @ X @ G
. . . . . . . . . . . . X
. . . . . . S3 . . . . . .
. . . . . . . . . . . . .
. . . . . . . . . . . . .
. X . . . . . . . . X . .
. . G . . . . . . . . . .
. L2N @ . . . G . . . . S2 L2S
@ . G S0 . . . . . . . . .
. . S1 . . . . . . . . . .