. . . . . . . . . . . . S0
. . . . . . . . L0S . . . .
. . . . . . . . . . . . .
. . . @ . . . L1N X . . . .
. . . . X . . . . . . . .
. . . . . . . . . . @ . .
. . . . . . G . . . @ . .
. . . . . @ . . . G . . .
. . . . X . . . . . . . .
G X . . G . . @ . . . . .
. . . . . S3 . . . S2 S1 . .
. . . . . . . . . . . . .