. @ . . . . . . . . . . .
. . @ . . X . . . . . . .
. . . . S1 S2 . . . . . @ X
. . . . . . . . . . X . .
. . . . . . . . . S0 . . L2N
. . . . . . . . S3 . . G .
. . . . . . . . . . . L3W .
. . . . . . . . . . . . .
. . G . G . . . . . @ . .
. . . . . . . . . . . G .
. . . . . . X . . . . . .
. @ . . . . . . . . . . .