. . . . . . . . . . . @ .
. . . . . . . . . . . . @
. . . . . . . . . . . G .
. . S3 . . . . . L0S . . S1 .
. . . . . @ . . S0 @ . . .
. . G . . . . . . . X . .
G . . L2N . . . . X . . . .
. . . . . . . . . . . . .
. . . X . . S2 . . . . . .
. . . . . . . . . . . . .
. @ . G . X . . . . . . .
. . . . . . . . . . . . .