. . . . . . S3 . @ . . @ .
. . . . . . . . . . . . .
. . . . . . . . . . . . .
. . . . . . . . L1W S1 . . .
. . . . . . . . . . . . .
. X . . S2 . . . . . . . .
X . G . . X . . @ . . . .
. . . . X G . . . . . . .
. . . . . . . . . . . . .
L1S @ . . S0 . G . . . . . .
. . . . . . . . . . . . .
. . . . . . . G . . @ . .