. . . . . . . . . . . . .
S2 . . . . . . . . . . S3 .
. . . X . . . . . . . . .
. . . . . . @ . . . . . .
. . . . G X @ . . . . . .
. . . . . . . . . . S1 S0 .
@ G . . . . . . . L2S X . .
. . . . . . . . . . L3S . .
. . . . . . . . @ . . . .
. . . . . . . . G . . . .
. . . @ . . . . . . . . .
. . X . . G . . . . . . .