. .  . L0W . .  . X .  .  .  . .
. .  .  .  . .  . . .  .  .  . .
. .  .  .  . .  . . .  .  .  X .
. .  .  .  . .  . . .  .  .  . X
. @  .  .  . .  X . .  .  .  G .
. .  .  .  . .  . . .  .  .  . S2
. .  G  .  . . S1 . . L1W .  . .
. .  .  .  . .  . @ .  .  .  . .
. .  .  .  . .  . . .  .  S0 . .
. .  .  G  @ .  . . .  .  .  . .
. . S3  .  . .  . @ .  .  .  . .
. .  .  .  . .  . G .  .  .  . @