. . . . . . . . . . . . .
. . @ . . . . . . @ . . .
. . . . . . . . L1N S0 . . .
. . . . . . . . . . . . .
. . L2E . . . . . . S2 @ @ .
. . G . . S3 . S1 . . . . .
. . G . . . . . . . . . .
. . . . . . . . . . . X .
G . . . . . . . . . . . .
. . . . X . @ . . . . . .
. X . . . X . . . . . . .
G . . . . . . . . . . . .