. . . X . . . . . . . . .
. . . . . . S2 G L0E . . . .
. S3 . . S0 . . . . . L2E . .
. . . . . . . . . X . . .
. . . . . . . . G . . . .
. . . . . . . . . . @ . .
. . . . . . . . . . . . G
. . . X . S1 @ @ . . . . .
@ . . . . . . . . . G . .
. . . . . . . . . . . X .
. . . . . . . . . . . . .
. . . . . . . . . @ . . .