. @ . . . . @ . . . . . .
. S2 . . . . . . . . X . .
. . . . L2N . . . S1 . . . .
. . . . . . . . . . . . .
. . . . X . . . . . . . @
. . . L2S . . . . . @ . . .
X . . . . . . . . . . X G
G . . . . @ G . . . . . .
. . . . . . . . . . . . .
. . . . . . . . . G . . .
. . . . . . . . . . . . .
. . S3 . . . . . . . . . S0