. . . . . . . . . . . G .
. . . . . . . . . G . . .
. . G . . . . . . . . . .
. . . @ . . . . . X . . @
. . . . . . . . . . . . X
. . S1 . L2N . . . . . . . L0W
. X S0 . . . . . . . . . .
. . . . . . . G @ . . . .
. . . . . . . . . . . . .
. . . . . . . . . . S3 . .
. . S2 @ X . . . . . . . .
. . . . . @ . . . . . . .