. . . . . . . . . X . . .
. @ G . . . S1 X . . . . .
@ . . . . . . . . L0W . . .
. . . . . . . . . . . . .
. . . . . . . . . . . . .
. . . . S2 S3 . X @ S0 . . L3S
. . . . . . . . . . . @ .
. . X . . . . . . . G . .
. . . . . . . . . . . . .
. . . . . . . . . . . . G
. . . . . . @ . . . . . .
. . . . . . G . . . . . .