. . . . . . . . . . . . .
. . . . . . . . S1 . . . .
. . . . . . @ . . . . . .
. . . . . . . . . . . . .
. @ . . . . . . . X . . .
S2 . . . . . . . . . . . .
. . . . . . . . . . . . .
. . . . . G S0 . . . . . L2N
. . . L0S S3 . G . X . . . .
. . . . . . . . . @ G . .
. X . X . . . . . G . . .
@ . @ . . . . . . . . . .