. . X . . L1E . . @ . . . .
. . . . . . S3 . . . . . .
. . @ . X . . . . . . . .
X . . . . . . S2 . . . . .
. . . . . . . . . . . . .
. . . . . . . . X . . . .
. S0 L1N . S1 . . . . . . . G
. . . . @ . . . @ . . G .
. . . . . . . . . @ . . .
. . . . . . . . . . . . .
. . . . . . . . . . . . G
. . . . . . G . . . . . .