. . @ . . . . . . . . . G
. . . . G . . @ . . . . .
. . . . . . . . . . . . @
. . . . . . . . . . . . .
. . . G . G . . . L3E . . .
X . L3S . . . . . . . . . .
. . . . . . . . . . . . .
. . . . @ . X . . . . . .
. . . . . . . . . . . . .
. . X . . . . . . . . . .
S0 . . . . . . @ . . X . .
. . . . . . . S3 . . S2 S1 .