. . . . . . . . . . . . .
. . . . . . . L1W . . . . S1
. . . . X X . S3 . . . L1S @
S0 X . . . . . . . . . . .
. . . . . . . . . . . . .
. . . . . . . . . . . . .
. . . . @ . . . . . . . .
@ . S2 . . . . . . G G . .
. G . . @ . . . . . . X .
. . . . . . . . . . . @ .
. . . . . . . . . . . . .
. . . . . . . . . . G . .