. @ .  . . . .  .  .  X  .  .  .
. . .  . . . .  .  . S3  .  .  .
. . .  . . @ .  .  .  .  .  .  .
. . .  . . . . L1W G  .  .  @  .
. . .  . . . .  .  @  .  .  .  @
. . .  . . . .  .  X  X  .  .  .
. . .  . . . .  .  .  X  .  .  .
. . .  . . . .  .  .  . L3W S1 .
. . .  . . . .  .  .  .  .  .  .
. . . S2 . . .  S0 G  .  .  .  .
. . .  . G . .  .  .  .  .  .  .
. . .  . . . G  .  .  .  .  .  .