. . . . L0N . @ . . . . . .
. . . X . . . G . G . . .
. . . . . . X . . . . . .
. . . . . . . S3 . @ . . S1
. . . . S0 S2 . . . . . . .
. . . . . . . . . . . . .
@ . . G . . . . . . . . .
@ . . . . . . . . . . . .
. L0W . . . . . . . . . . .
. . . . . . . X . . . . .
. . . . . X . . . . @ . .
. . . . . . . . . . G . .