@ . . . X . . . . . . . .
. . . . . . . . . . . . .
. . . . . . . . S0 L2S . . .
@ . . . . . . . . . . . .
. . G . L1W G . . S2 . . X .
S1 . . . . . . . G . . . .
. . S3 . . . . . . . . . .
. . . . . . . . . X . . .
. . . . . . . . . . . . .
. @ . . . . . . . . . @ X
. . . . G . . . . . . . .
. @ . . . . . . . . . . .