. . . . . . . . . . . . .
. . . . . @ . . . . . . .
. . . . . . . . . . . . .
. . . . . . . X . . X . .
. . . @ . . . . . . . . .
. . . . . . . . . L2W . L2W @
. . . . G . . . . . . . .
. . . . @ . . . . . S0 . .
. . . . . . . . . . @ . .
G . . . . . . . X . S3 . .
. . . . . . . . X . G . .
. . . . . . . . S2 . G . S1