. . X . . . . . X . S3 . @
. . . . . . . . . . . . .
. . . . G S0 . . . @ . S2 .
. . . . . . . . . . . . .
. . . . X . . . . . . . .
. . . . . . S1 . L3E . . . .
. X . . . G G . . . . . .
. . . G . . . . . . . . .
. . . . . . . . . . . . .
. . . . . . . . . . . L2S .
. . . . . . @ . @ . . @ .
. . . . . . . . . . . . .