S0  .  .  .  .  .  .  .  .
.  .  F  .  .  .  @  .  .
.  .  .  .  .  .  .  .  .
.  .  .  @  .  @  .  .  .
.  G  .  .  .  .  .  @  .
.  G  .  .  .  .  .  .  G
.  .  .  .  .  .  S1  G  .
.  G  .  .  L1N  .  @  .  L1S
.  .  .  .  .  .  .  F  @