.  G  .  .  .  .  .  .  .
.  .  .  @  .  .  .  .  .
.  .  .  G  .  .  .  .  .
.  .  .  .  .  .  .  .  .
@  F  .  .  @  .  S0  @  .
.  .  .  .  S1  @  .  .  .
.  .  .  .  .  .  .  .  .
.  .  L0E  .  .  L1E  G  .  .
.  @  .  .  .  F  .  G  G