.  .  .  .  .  .  .  .  L0S
.  .  @  G  @  .  S1  F  .
.  .  .  .  .  .  .  .  .
@  F  @  .  .  .  .  .  .
.  .  .  .  .  @  .  .  .
.  .  .  .  .  .  .  .  .
.  .  .  @  .  .  .  .  G
.  G  .  .  .  .  .  .  G
G  .  L0W  .  .  S0  .  .  .