.  .  .  G  .  .  @  .  @
@  .  .  .  S0  .  .  L0S  .
@  .  .  .  .  .  .  .  .
.  .  .  .  .  .  @  .  .
.  .  .  .  .  .  S1  .  G
F  .  .  .  .  .  .  .  .
.  .  .  .  .  .  @  .  .
.  .  F  .  .  G  .  G  .
L1N  .  .  G  .  .  .  .  .