.  @  .  G  G  .  .  .  L1N
.  @  .  .  .  .  .  @  .
.  .  .  .  .  G  .  .  .
.  .  .  .  S1  @  .  .  .
.  .  .  .  .  L1S  .  .  S0
.  .  .  .  .  .  .  .  .
.  .  .  .  .  .  .  @  .
.  @  G  .  F  .  .  F  G
.  .  .  .  .  .  .  .  .