.  .  .  .  @  .  .  .  .
.  .  G  .  .  G  .  .  .
G  .  .  .  .  .  .  .  .
.  .  .  .  .  .  G  @  @
.  .  .  .  G  .  @  F  .
.  .  .  .  .  .  .  .  .
.  .  .  .  .  .  .  S1  .
.  .  .  @  L0W  F  .  .  .
.  .  .  S0  L0E  .  .  @  .