.  S0  .  .  .  .  .  .  @
.  .  @  .  .  .  .  .  .
.  F  .  .  G  G  .  .  @
.  .  .  .  .  .  .  .  .
.  G  .  S1  .  .  .  F  .
L0E  @  .  @  .  .  L1N  .  .
.  .  .  .  .  .  .  .  .
.  .  .  .  .  .  .  .  .
G  .  .  @  .  G  .  .  .