L1E  .  G  .  .  @  .  .  @
G  .  .  .  .  .  .  .  .
.  S0  .  .  .  @  .  .  .
.  .  .  .  .  .  .  .  .
.  .  .  .  .  .  .  .  .
.  .  .  .  .  @  .  .  .
.  .  .  .  S1  .  G  .  .
.  G  .  .  .  @  .  .  .
.  F  .  .  .  .  @  G  F