F  G  .  .  .  .  .  .  .
.  .  .  .  .  .  .  .  @
.  .  .  .  .  S1  .  .  .
@  .  @  L1N  .  G  .  @  L0S
.  .  .  .  .  .  .  .  .
.  .  .  .  .  .  S0  .  .
@  .  .  .  .  .  .  .  F
.  .  .  .  .  @  .  G  .
.  .  .  G  .  .  .  .  G