.  .  .  .  .  .  G  .  .
.  .  .  .  .  @  .  .  .
.  @  S1  .  .  .  .  .  .
.  .  G  .  .  @  .  G  .
.  .  G  S0  .  .  .  .  .
.  .  .  .  L0S  .  G  .  .
.  .  .  .  @  .  .  .  .
.  .  .  @  .  .  .  .  .
.  F  @  .  .  .  .  .  F