.  .  S0  .  .  G  .  .  G
L1E  .  .  @  .  .  F  .  .
.  .  .  .  G  .  .  .  .
@  .  F  .  .  .  .  .  .
.  .  .  .  .  .  .  .  .
@  .  G  .  @  .  .  .  .
.  .  .  .  .  .  .  G  .
@  .  .  .  .  .  S1  L1E  .
.  .  .  .  .  .  .  .  @