.  .  S0  .  @  .  @  .  G
@  .  .  .  L0S  .  .  F  .
.  .  .  .  .  .  .  .  .
.  F  .  .  .  .  .  .  .
.  .  .  .  .  .  @  @  .
.  .  .  S1  L1E  .  G  .  .
.  @  .  .  .  .  G  .  .
.  .  .  .  .  .  .  .  .
.  .  G  .  .  .  .  G  .