.  .  .  .  .  G  .  .  S0
.  .  .  .  @  .  .  .  .
.  .  .  .  .  .  .  F  .
.  .  L1E  .  .  .  .  L0E  @
@  .  .  F  .  .  .  .  .
.  .  @  .  .  .  .  G  G
.  .  .  .  .  .  .  .  .
@  S1  .  .  .  .  G  .  .
.  .  .  .  .  G  .  @  .