.  .  G  .  @  .  .  .  .
@  .  .  .  .  .  .  .  .
G  .  .  L0E  .  G  .  F  .
.  .  .  F  .  .  @  .  .
.  .  .  .  .  .  .  .  .
.  .  .  .  .  .  .  .  .
.  .  S0  @  .  .  .  G  .
.  .  .  .  .  .  @  .  .
L0W  .  .  .  @  S1  G  .  .