.  .  .  .  .  .  .  S1  @
G  .  .  G  .  .  .  @  .
@  .  .  .  .  .  .  .  .
.  .  G  .  .  @  .  F  .
.  .  .  .  .  F  .  .  .
.  .  .  S0  .  .  .  L1N  @
G  .  .  .  .  .  .  .  @
.  .  .  L0E  .  .  .  .  .
.  .  .  .  .  G  .  .  .