.  .  .  S0  @  .  .  G  S1
.  .  .  .  .  .  .  .  .
.  .  .  .  .  .  .  .  .
.  .  .  .  .  F  .  .  .
.  .  @  @  L1N  .  .  G  .
.  G  .  .  G  .  .  .  .
.  .  .  G  .  .  .  .  L0S
.  .  .  .  .  @  @  .  @
.  .  .  .  .  .  .  .  F