.  @  .  F  .  .  G  .  .
.  @  .  G  .  .  .  .  .
.  .  .  .  .  .  .  .  @
L0W  .  .  .  .  @  .  G  .
.  .  .  .  .  .  .  .  .
.  .  .  .  L1N  F  S0  .  .
.  .  .  .  .  .  .  .  S1
.  @  .  .  .  G  .  .  .
.  .  G  .  .  .  .  @  .