.  .  .  .  .  .  .  @  .
.  .  .  .  L0E  .  .  .  .
.  @  G  .  .  .  .  .  .
.  .  .  .  .  @  .  .  .
@  .  .  G  .  .  .  @  .
F  G  .  .  .  G  .  F  .
.  .  .  .  .  .  .  S0  L0S
.  .  .  .  .  .  G  .  .
.  .  .  .  .  .  @  S1  .