.  .  .  .  L0N  .  S1  .  @
.  .  .  .  .  F  .  G  .
.  .  .  .  .  .  .  .  G
.  S0  .  .  .  G  .  .  .
.  .  .  .  .  @  .  @  .
.  .  .  F  G  .  .  .  .
.  .  .  .  .  .  .  .  G
.  .  @  .  L1E  @  .  .  @
.  .  .  .  .  .  .  .  .