G  .  .  .  G  .  .  .  .
.  .  .  @  .  .  .  .  @
@  .  .  .  .  .  .  .  .
.  .  .  .  F  .  L0W  .  .
.  .  .  .  @  .  S1  .  L1S
.  .  .  .  .  @  F  .  .
G  .  .  .  .  G  .  .  .
.  @  .  .  .  .  .  S0  .
.  .  .  .  .  .  .  .  G