@  .  S1  .  G  G  .  .  .
.  .  .  .  .  .  .  .  .
@  .  .  .  .  .  @  F  @
.  .  .  .  .  .  .  G  .
.  @  .  .  .  .  L1W  .  .
.  .  .  .  .  .  .  .  G
.  @  .  .  .  .  .  .  .
G  .  L0E  S0  .  .  .  .  .
.  .  .  F  .  .  .  .  .