.  .  .  .  .  .  .  .  .
.  .  F  .  S1  .  .  .  @
S0  .  .  .  .  @  L0N  .  .
.  .  @  L1N  .  .  .  @  .
.  .  .  .  .  .  .  .  .
F  .  .  .  .  .  .  .  G
.  .  G  .  .  .  .  @  .
.  .  .  .  .  .  G  G  .
.  .  .  .  @  .  G  .  .