F  G  .  .  .  .  @  .  .
.  .  @  .  S0  .  .  .  .
.  L0E  .  G  .  .  .  .  .
.  .  .  .  .  .  .  .  .
@  .  .  .  .  .  .  .  .
.  G  .  .  @  .  .  .  .
.  .  @  .  .  .  .  @  .
G  .  .  .  .  .  .  .  .
.  G  L0W  .  .  .  F  S1  .