.  .  .  .  .  S0  .  .  .
F  G  .  .  .  .  @  .  .
@  .  S1  .  @  .  .  .  G
.  .  .  .  .  .  F  .  .
.  .  .  .  .  .  .  .  .
.  .  .  .  @  .  .  @  .
@  .  .  .  .  .  .  .  .
L0E  .  .  .  .  L1E  G  .  G
.  .  .  G  .  .  .  .  .