G  .  .  .  .  .  .  .  .
.  .  .  .  .  .  G  S1  .
.  .  .  .  .  .  .  .  .
F  .  @  .  .  .  .  .  L1W
F  .  .  .  @  .  .  .  G
.  .  .  .  @  .  .  .  .
.  .  .  .  .  .  G  .  .
.  .  .  S0  .  @  .  .  @
.  .  .  .  G  .  @  .  .