.  .  S0  .  .  G  S1  G  .
.  .  .  .  G  .  .  .  .
G  .  .  .  .  .  .  .  .
.  .  .  .  .  .  .  .  .
.  @  .  .  .  .  .  F  F
@  .  .  .  .  .  .  @  @
.  .  @  .  .  .  @  L0W  G
.  .  .  .  .  .  L0W  .  .
.  .  .  .  .  .  .  .  .