.  .  .  .  .  .  .  .  .
@  G  .  .  .  .  .  @  .
.  @  @  .  .  G  .  .  .
.  S1  .  G  .  .  .  .  @
.  .  .  .  .  .  .  .  .
.  .  .  .  .  .  .  L1W  L0E
.  .  .  F  .  .  .  @  .
G  G  .  .  .  .  .  .  .
.  .  .  .  .  .  S0  .  F