.  .  @  .  .  G  .  .  .
.  .  .  G  .  @  F  .  .
S1  .  .  .  .  .  .  G  .
.  .  .  .  .  .  G  .  .
.  .  .  .  .  @  .  @  .
.  .  .  .  .  .  .  .  .
.  .  .  .  L0W  .  .  .  .
.  G  .  .  .  .  .  .  .
@  .  @  .  .  F  L0W  S0  .