.  .  .  @  .  .  .  .  .
.  @  .  .  F  .  .  .  .
.  .  .  .  .  .  .  .  @
.  .  .  .  .  .  .  G  .
.  G  G  .  .  .  .  .  .
.  .  .  G  .  .  .  L0E  .
.  S1  F  .  S0  .  .  .  .
.  .  .  .  @  .  @  .  .
@  G  .  .  .  .  .  L0N  .