G  G  .  F  G  .  .  .  .
.  .  @  .  .  .  .  .  .
.  @  .  .  G  .  .  @  .
.  .  .  .  .  .  .  .  .
S1  .  L0E  .  .  .  .  .  @
.  .  F  .  .  .  .  .  .
.  .  L0S  .  .  .  .  .  .
.  .  @  .  .  .  .  .  .
.  .  .  .  .  .  G  @  S0