.  S0  .  .  G  .  @
L1S  S1  .  L1N  .  .  .
.  .  .  .  .  @  .
.  .  .  .  F  .  .
.  F  G  .  .  .  .
.  .  .  .  G  .  .
G  G  .  .  .  .  .