S0  .  G  .  .  .  .
G  .  .  .  .  .  .
.  .  .  .  .  .  .
G  .  .  .  .  F  .
.  .  G  .  L1S  @  S1
.  .  @  .  F  .  .
.  .  .  .  G  .  .