.  .  G  @  .  G  .
.  .  .  L0S  .  .  S0
.  G  .  .  .  .  .
.  G  .  .  @  .  .
G  .  .  .  F  .  .
.  .  S1  F  .  .  .
.  .  .  .  .  .  .